
SO ./MAIN.c
WE ./MAIN.c
EA ./MAIN.c
NO ./MAIN.c


F 220,100,0
C 225,30,255

111111
101111
100101
101001
1100N1
111111