
SO ./MAIN.c
WE ./MAIN.c
EA ./MAIN.c
NO ./MAIN.c


F 220,100,0
C 225,30,0

111111
100101
101001
1100N1
111111