NO cub3d
SO cub3d
WE cub3d
EA cub3d

C 255,1,1
F ,1,1

11111111111111
10000000000N01
11111111111111
