SO ./wall_texture/brique_texture.xpm
WE ./wall_texture/metal.xpm
EA ./wall_texture/textureb.xpm
NO ./wall_texture/texturea.xpm

C 255,1,1
F ,1,1

11111111111111
10000000000N01
11111111111111
