NO ./filetest.xpm
SO ./filetest.xpm
WE ./filetest.xpm
EA ./filetest.xpm

C 255,1,1
F 255,1,56

    11111111
    10000001            1
11111111111111
10000000000001
11111111111111



 

11111111111111





              N            
