NO ./filetest.xpm
SO ./filetest.xpm
WE ./filetest.xpm
EA ./filetest.xpm

C 255,1,1
F 255,5,5

    11111111
    100000011
11111111111111
1000000000001N
11111111111111


111111111111111
1111
11
1111