SO ./wall_texture/brique_texture.xpm
WE ./wall_texture/metal.xpm
EA ./wall_texture/textureb.xpm
NO ./wall_texture/texturea.xpm


F 169,169,169
C 15,50,2

        1111111111111111111111111
        1000000000110000000000001
        1011000001110000000000001
        1001000000000000000000001
111111111011000001110000000000001
100000000011000001110111111111111
11110111111111011100000010001   
11110111111111011101010010001
11000000110101011100000010001
10000000000000001100000010001
10000000000000001101010000001
11000001110101011111011010N1111
11110111 1110101 10111101000001
11111111 1111111 11111111111111
